0000000000000000
1111111111111111
0001001000110100
1010101010101010
0000000000000001
0000000000000010
0000000000000011
0000000000000100
0000000000000101
0000000000000110
0000000000000111
0000000000001000